□□□□□□□□□□□
□....□....□
□....□....□
□.........□
□....□....□
□□□.□□□.□□□
□....□....□
□.........□
□....□....□
□....□...O□
□□□□□□□□□□□
