........
.......O
........
________
.......O
........
........
________
........
........
...O....
