........
.......O
........
□□□□□□□□
.......O
........
........
□□□□□□□□
........
........
...O....
