□□□□□□□□□□□□
□□.O.□□□□□□□
□□...□□□□□□□
□□□□.□□□...□
□..□.□□□□□.□
□..□.□□□□□.□
□..........□
□..□.□□□□□.□
□□□□.□□□□□.□
□□...□□□...□
□□...□□□□□□□
□□□□□□□□□□□□
