□□□□□□□□□□□□□
□.....□.....□
□.....□.....□
□.....←.....□
□.....□.....□
□.....□.....□
□□↓□□□□.....□
□.....□□□↑□□□
□.....□.....□
□.....□.....□
□.....→.....□
□.....□....O□
□□□□□□□□□□□□□
