□□□□□□□□□□□□□
□.....□.....□
□.....□.....□
□...........□
□.....□.....□
□.....□.....□
□□.□□□□.....□
□.....□□□.□□□
□.....□.....□
□.....□.....□
□...........□
□.....□....O□
□□□□□□□□□□□□□
