□□□□□□□□□□□□□
□...←.□.....□
□...□↑□.....□
□???........□
□□↓□□□□□....□
□......□....□
□......□....□
□......□□□.□□
□......□....□
□......□....□
□......←....□
□......□...O□
□□□□□□□□□□□□□
