□□□□□□□□□□□□□
□.....□.....□
□.....□.....□
□???........□
□□↓□□□□□....□
□..←←..□....□
□..←→..□....□
□..←→..□□□.□□
□..←→..□....□
□..←→..□....□
□..←→..←....□
□..→→..□...O□
□□□□□□□□□□□□□
