□□□□□□□□□□□□□
□.....□.....□
□.....□.....□
□...........□
□.....□.....□
□.....□.....□
□□↓□□□□.....□
□.....□□□_□□□
□.....□.....□
□.....□.....□
□.....←.....□
□.....□....O□
□□□□□□□□□□□□□
