□□□□□□□□□□□□□□□□
□□□............□
□□□............□
□□□.....□□□□□□□□
□□□□□...□□□□□□□□
□□□□□...□□□□□□□□
□..............□
□..............□
□□□□□□□□...□□□□□
□□□□□□□□...□□□□□
□□□□.......□□□□□
□□□□.......□□□□□
□O.............□
□□□□□□□□□□□□□□□□
