................
................
...............O
................
□□□□□□□□□□□□□□□□
................
...............O
................
................
□□□□□□□□□□□□□□□□
................
................
................
........O.......
