................
................
...............O
................
________________
................
...............O
................
................
________________
................
................
................
........O.......
