□□□□□□□□□□□□□□□□□□□
□.....□.....□.....□
□.....□.....□.....□
□.....→.....→.....□
□.....□.....□.....□
□.....□.....□.....□
□□□↑□□□□□□□□□□□↓□□□
□.....□.....□.....□
□.....□.....□.....□
□.....→.....←.....□
□.....□.....□.....□
□.....□.....□.....□
□□□↓□□□□□□□□□□□↑□□□
□.....□.....□.....□
□.....□.....□.....□
□.....→.....→.....□
□.....□.....□.....□
□.....□.....□.....□
□□□□□□□□□□□□□□□□□□□
