□□□□□□□□□□□□□□□□□□□□□□□□□□□
□........□........□.......□
□........□........□.......□
□........□........□.......□
□........→........→.......□
□........□........□.......□
□........□........□.......□
□........□........□.......□
□........□........□.......□
□□□□↑□□□□□□□□↓□□□□□□□□↓□□□□
□........□........□.......□
□........□........□.......□
□........□........□.......□
□........→........→.......□
□........□........□.......□
□........□........□.......□
□........□........□.......□
□........□........□.......□
□□□□↑□□□□□□□□↓□□□□□□□□↓□□□□
□........□........□.......□
□........□........□.......□
□........□........□.......□
□........←........←.......□
□........□........□.......□
□........□........□.......□
□........□.......O□.......□
□□□□□□□□□□□□□□□□□□□□□□□□□□□
