□□□□□□□□□□□□□□□□□□□
□.....□.....□.....□
□.....□.....□.....□
□.....←.....←.....□
□.....□.....□.....□
□.....□.....□.....□
□□□□□□□□□↓□□□□□↑□□□
□.....□.....□.....□
□.....□.....□.....□
□.....□.....→.....□
□.....□.....□.....□
□.....□.....□.....□
□□□↑□□□□□↓□□□□□↓□□□
□.....□.....□.....□
□.....□.....□.....□
□.....←.....□.....□
□.....□.....□.....□
□.....□.....□.....□
□□□□□□□□□□□□□□□□□□□
