□□□□□□□□□□□□□□□□□□□□□□□□□□□□□□□□□□□□□□□□□□□
□.....□.....□.....□.....□.....□.....□.....□
□.....□.....□.....□.....□.....□.....□.....□
□.....←.....←.....←.....→.....→.....→.....□
□.....□.....□.....□.....□.....□.....□.....□
□.....□.....□.....□.....□.....□.....□.....□
□□□↓□□□□□□□□□□□□□□□□□↑□□□□□□□□□□□↑□□□□□↓□□□
□.....□.....□.....□.....□.....□.....□.....□
□.....□.....□.....□.....□.....□.....□.....□
□.....→.....□.....→.....→.....→.....←.....□
□.....□.....□.....□.....□.....□.....□.....□
□.....□.....□.....□.....□.....□.....□.....□
□□□↓□□□□□□□□□□□↑□□□□□□□□□□□□□□□□□↑□□□□□↓□□□
□.....□.....□.....□.....□.....□.....□.....□
□.....□.....□.....□.....□.....□.....□.....□
□.....→.....→.....←.....→.....→.....→.....□
□.....□.....□.....□.....□.....□.....□.....□
□.....□.....□.....□.....□.....□.....□.....□
□□□□□□□□□↑□□□□□□□□□□□↑□□□□□↑□□□□□□□□□□□↓□□□
□.....□.....□.....□.....□.....□.....□.....□
□.....□.....□.....□.....□.....□.....□.....□
□.....→.....□.....←.....→.....→.....←.....□
□.....□.....□.....□.....□.....□.....□.....□
□.....□.....□.....□.....□.....□.....□.....□
□□□↑□□□□□□□□□□□↓□□□□□↓□□□□□□□□□□□□□□□□□↑□□□
□.....□.....□.....□.....□.....□.....□.....□
□.....□.....□.....□.....□.....□.....□.....□
□.....→.....□.....←.....→.....→.....→.....□
□.....□.....□.....□.....□.....□.....□.....□
□.....□.....□.....□.....□.....□.....□.....□
□□□↑□□□□□□□□□□□↓□□□□□□□□□□□□□□□□□↑□□□□□□□□□
□.....□.....□.....□.....□.....□.....□.....□
□.....□.....□.....□.....□.....□.....□.....□
□.....←.....←.....←.....→.....→.....→.....□
□.....□.....□.....□.....□.....□.....□.....□
□.....□.....□.....□.....□.....□.....□.....□
□□□↓□□□□□↑□□□□□↑□□□□□↑□□□□□↑□□□□□↓□□□□□□□□□
□.....□.....□.....□.....□.....□.....□.....□
□.....□.....□.....□.....□.....□.....□.....□
□.....→.....→.....→.....□.....←.....→.....□
□.....□.....□.....□.....□.....□.....□.....□
□.....□.....□.....□.....□.....□.....□.....□
□□□□□□□□□□□□□□□□□□□□□□□□□□□□□□□□□□□□□□□□□□□
