□□□□□□□□□□□□□□□□□□□□□□□□□□□□□□□
□.....□.....□.....□.....□.....□
□.....□.....□.....□.....□.....□
□.....←.....←.....←.....→.....□
□.....□.....□.....□.....□.....□
□.....□.....□.....□.....□.....□
□□□↓□□□□□□□□□□□□□□□□□↑□□□□□↓□□□
□.....□.....□.....□.....□.....□
□.....□.....□.....□.....□.....□
□.....→.....□.....→.....□.....□
□.....□.....□.....□.....□.....□
□.....□.....□.....□.....□.....□
□□□□□□□□□↑□□□□□↑□□□□□□□□□□□□□□□
□.....□.....□.....□.....□.....□
□.....□.....□.....□.....□.....□
□.....□.....←.....→.....→.....□
□.....□.....□.....□.....□.....□
□.....□.....□.....□.....□.....□
□□□↑□□□□□↓□□□□□↓□□□□□□□□□□□↓□□□
□.....□.....□.....□.....□.....□
□.....□.....□.....□.....□.....□
□.....←.....←.....←.....←.....□
□.....□.....□.....□.....□.....□
□.....□.....□.....□.....□.....□
□□□↓□□□□□□□□□□□□□□□□□↑□□□□□↓□□□
□.....□.....□.....□.....□.....□
□.....□.....□.....□.....□.....□
□.....→.....→.....□.....←.....□
□.....□.....□.....□.....□.....□
□.....□.....□.....□.....□.....□
□□□□□□□□□□□□□□□□□□□□□□□□□□□□□□□
